id,label,start_ms,end_ms,duration_ms,n_keyframes
violence-304,violence,7600,8600,1000,5
violence-305,violence,9200,9800,600,2
clown-61,clown,12200,12400,200,1
violence-306,violence,13000,14000,1000,5
snake-220,snake,15000,15600,600,3
snake-221,snake,17200,17400,200,1
snake-222,snake,19200,19400,200,1
blood-5,blood,20600,20800,200,1
snake-223,snake,20600,20800,200,1
violence-307,violence,20800,25800,5000,24
violence-308,violence,20800,21200,400,2
violence-309,violence,21000,21400,400,2
item-160,item,21200,21400,200,1
violence-310,violence,22000,22400,400,2
violence-311,violence,22000,25800,3800,18
violence-312,violence,22000,22200,200,1
violence-313,violence,23200,23400,200,1
violence-314,violence,24000,24200,200,1
violence-315,violence,24200,24400,200,1
snake-224,snake,25800,26600,800,2
violence-316,violence,25800,26000,200,1
item-161,item,26400,26600,200,1
violence-317,violence,26800,28200,1400,3
violence-318,violence,27000,32200,5200,14
violence-319,violence,28800,29600,800,4
violence-320,violence,30200,35800,5600,21
item-162,item,31600,31800,200,1
item-163,item,31800,32000,200,1
violence-321,violence,32200,32800,600,3
violence-322,violence,33400,33800,400,2
violence-323,violence,34400,35000,600,2
violence-324,violence,35600,35800,200,1
snake-225,snake,36400,36600,200,1
clown-62,clown,39400,39600,200,1
violence-325,violence,40600,44600,4000,16
spider-263,spider,41200,41600,400,2
spider-264,spider,42200,42400,200,1
violence-326,violence,43800,44600,800,3
item-164,item,44600,44800,200,1
spider-265,spider,44600,44800,200,1
violence-327,violence,45400,54000,8600,41
item-165,item,46000,46200,200,1
violence-328,violence,46800,47200,400,2
clown-63,clown,48200,48400,200,1
clown-64,clown,49800,50800,1000,3
violence-329,violence,50000,50200,200,1
item-166,item,50800,51000,200,1
clown-65,clown,51400,51600,200,1
violence-330,violence,52000,52200,200,1
clown-66,clown,54000,54800,800,4
snake-226,snake,57400,59000,1600,6
violence-331,violence,60000,60200,200,1
clown-67,clown,61000,61200,200,1
blood-6,blood,64400,65600,1200,4
violence-332,violence,64400,64600,200,1
blood-7,blood,68800,69800,1000,4
violence-333,violence,73000,78400,5400,26
item-167,item,81200,87200,6000,28
clown-68,clown,87200,87400,200,1
snake-227,snake,88400,88600,200,1
clown-69,clown,88600,88800,200,1
clown-70,clown,89600,90000,400,2
clown-71,clown,92400,92800,400,2
item-168,item,92400,93000,600,3
clown-72,clown,94800,96400,1600,8
violence-334,violence,95200,95400,200,1
item-169,item,95400,95600,200,1
snake-228,snake,96600,98600,2000,8
violence-335,violence,99600,105600,6000,27
item-170,item,100200,100600,400,2
item-171,item,103400,106000,2600,10
violence-336,violence,106200,106800,600,3
item-172,item,106800,108400,1600,5
violence-337,violence,108400,109400,1000,5
clown-73,clown,109600,110800,1200,3
blood-8,blood,110000,110200,200,1
clown-74,clown,112000,113200,1200,5
violence-338,violence,113200,113400,200,1
blood-9,blood,113800,114200,400,2
clown-75,clown,114000,114200,200,1
snake-229,snake,115200,115400,200,1
spider-266,spider,116800,117000,200,1
violence-339,violence,118600,118800,200,1
violence-340,violence,119400,119800,400,2
violence-341,violence,120600,120800,200,1
violence-342,violence,121600,122000,400,2
violence-343,violence,122800,123000,200,1
blood-10,blood,123200,125000,1800,6
clown-76,clown,123600,123800,200,1
violence-344,violence,123600,123800,200,1
clown-77,clown,123800,124000,200,1
violence-345,violence,125000,125800,800,3
clown-78,clown,129000,129200,200,1
blood-11,blood,129200,129600,400,2
snake-230,snake,130600,130800,200,1
violence-346,violence,134800,135000,200,1
snake-231,snake,137600,137800,200,1
snake-232,snake,142400,143800,1400,3
violence-347,violence,143800,148400,4600,23
blood-12,blood,145800,146000,200,1
blood-13,blood,147800,148000,200,1
snake-233,snake,148600,148800,200,1
clown-79,clown,149400,150200,800,2
spider-267,spider,150000,150200,200,1
violence-348,violence,150200,153000,2800,14
blood-14,blood,150600,151600,1000,3
violence-349,violence,152000,152200,200,1
violence-350,violence,154200,154600,400,2
violence-351,violence,155200,155400,200,1
clown-80,clown,155800,156000,200,1
violence-352,violence,156800,157000,200,1
violence-353,violence,158000,158200,200,1
clown-81,clown,162000,162200,200,1
clown-82,clown,167200,168000,800,4
violence-354,violence,169800,170800,1000,4
spider-268,spider,176000,176200,200,1
violence-355,violence,180000,180400,400,2
clown-83,clown,181200,181400,200,1
violence-356,violence,181800,185000,3200,14
clown-84,clown,183200,183400,200,1
violence-357,violence,185800,190200,4400,21
clown-85,clown,188200,188400,200,1
violence-358,violence,190200,195000,4800,22
clown-86,clown,190400,190800,400,2
violence-359,violence,190800,197200,6400,25
violence-360,violence,190800,191000,200,1
item-173,item,192000,192200,200,1
clown-87,clown,198000,198200,200,1
violence-361,violence,198000,200600,2600,13
item-174,item,198600,198800,200,1
clown-88,clown,199200,199600,400,2
clown-89,clown,200200,200400,200,1
spider-269,spider,200600,203600,3000,13
spider-270,spider,204400,205000,600,2
spider-271,spider,206200,207000,800,4
violence-362,violence,207000,216800,9800,48
item-175,item,209800,210000,200,1
violence-363,violence,211000,211200,200,1
blood-15,blood,212000,212200,200,1
spider-272,spider,216200,217000,800,4
spider-273,spider,218600,219400,800,4
violence-364,violence,219400,233000,13600,65
blood-16,blood,220000,221200,1200,3
snake-234,snake,220400,220800,400,2
blood-17,blood,222000,222600,600,3
snake-235,snake,222600,222800,200,1
violence-365,violence,223200,224600,1400,4
violence-366,violence,225600,225800,200,1
violence-367,violence,226600,228800,2200,7
violence-368,violence,229400,229800,400,2
blood-18,blood,231000,231200,200,1
violence-369,violence,231200,231400,200,1
FEET_EXPOSED-1,FEET_EXPOSED,232000,232400,400,2
violence-370,violence,232000,232200,200,1
violence-371,violence,232200,232400,200,1
violence-372,violence,232200,232400,200,1
clown-90,clown,232600,232800,200,1
violence-373,violence,233000,238600,5600,21
blood-19,blood,236800,237000,200,1
violence-374,violence,238000,238200,200,1
violence-375,violence,240000,249400,9400,38
snake-236,snake,242600,242800,200,1
blood-20,blood,243800,244000,200,1
violence-376,violence,246600,246800,200,1
violence-377,violence,247400,251200,3800,9
item-176,item,249400,249600,200,1
violence-378,violence,250000,250200,200,1
violence-379,violence,251000,259600,8600,37
blood-21,blood,259200,259400,200,1
violence-380,violence,259600,262000,2400,8
spider-274,spider,260000,260200,200,1
violence-381,violence,261800,262400,600,2
spider-275,spider,262600,262800,200,1
violence-382,violence,262800,275000,12200,52
violence-383,violence,263000,263200,200,1
spider-276,spider,264400,264600,200,1
violence-384,violence,264800,265200,400,2
violence-385,violence,266000,266600,600,3
FEET_EXPOSED-2,FEET_EXPOSED,269600,269800,200,1
violence-386,violence,271200,271400,200,1
clown-91,clown,271600,271800,200,1
item-177,item,272000,272200,200,1
violence-387,violence,272000,274200,2200,7
violence-388,violence,274800,277200,2400,11
violence-389,violence,275200,281800,6600,26
snake-237,snake,282200,283000,800,3
item-178,item,283400,283600,200,1
violence-390,violence,283800,288400,4600,15
spider-277,spider,284000,284800,800,2
violence-391,violence,285800,286000,200,1
clown-92,clown,286000,286200,200,1
violence-392,violence,286200,288400,2200,7
spider-278,spider,287000,287200,200,1
violence-393,violence,287600,287800,200,1
item-179,item,288400,288600,200,1
item-180,item,289800,290000,200,1
violence-394,violence,290600,297800,7200,31
violence-395,violence,293400,293600,200,1
violence-396,violence,296200,296400,200,1
spider-279,spider,297600,297800,200,1
item-181,item,298400,298600,200,1
violence-397,violence,298600,299600,1000,5
violence-398,violence,299200,299800,600,2
item-182,item,299800,300000,200,1
item-183,item,300200,300400,200,1
violence-399,violence,300400,302800,2400,11
item-184,item,301400,301600,200,1
violence-400,violence,302200,304600,2400,7
violence-401,violence,302600,305800,3200,11
violence-402,violence,303400,304400,1000,4
clown-93,clown,303800,304000,200,1
item-185,item,305400,305600,200,1
violence-403,violence,305400,305600,200,1
clown-94,clown,306400,307600,1200,5
violence-404,violence,306400,306600,200,1
violence-405,violence,307200,312000,4800,19
violence-406,violence,308400,308600,200,1
snake-238,snake,309000,309200,200,1
violence-407,violence,309000,309200,200,1
violence-408,violence,309200,310200,1000,4
snake-239,snake,310200,310400,200,1
item-186,item,311400,311600,200,1
violence-409,violence,311800,312200,400,2
violence-410,violence,312800,313000,200,1
violence-411,violence,313600,313800,200,1
violence-412,violence,314400,314600,200,1
snake-240,snake,321200,321400,200,1
blood-22,blood,323000,323200,200,1
violence-413,violence,324800,325000,200,1
clown-95,clown,325000,325400,400,2
violence-414,violence,325600,325800,200,1
item-187,item,326400,326800,400,2
violence-415,violence,326400,326600,200,1
violence-416,violence,328200,328400,200,1
violence-417,violence,329000,329200,200,1
snake-241,snake,329200,329400,200,1
item-188,item,330800,331000,200,1
violence-418,violence,332000,332600,600,3
violence-419,violence,334000,334200,200,1
snake-242,snake,335000,335200,200,1
violence-420,violence,335200,336000,800,4
clown-96,clown,335600,335800,200,1
violence-421,violence,335800,336200,400,2
violence-422,violence,336800,337600,800,4
spider-280,spider,337200,337400,200,1
violence-423,violence,337600,338800,1200,3
spider-281,spider,338000,338200,200,1
spider-282,spider,338800,339000,200,1
violence-424,violence,339200,339800,600,3
violence-425,violence,340600,340800,200,1
violence-426,violence,340600,340800,200,1
violence-427,violence,341000,341800,800,2
FEET_EXPOSED-3,FEET_EXPOSED,341200,341400,200,1
violence-428,violence,341800,342000,200,1
violence-429,violence,342600,342800,200,1
violence-430,violence,343800,344200,400,2
violence-431,violence,344800,345000,200,1
violence-432,violence,347000,347200,200,1
clown-97,clown,347400,347800,400,2
clown-98,clown,347600,347800,200,1
violence-433,violence,348200,349200,1000,3
violence-434,violence,350000,351400,1400,5
spider-283,spider,350800,351400,600,2
violence-435,violence,351000,351200,200,1
violence-436,violence,351800,352400,600,2
violence-437,violence,351800,352000,200,1
clown-99,clown,352600,354200,1600,4
violence-438,violence,352600,353400,800,3
violence-439,violence,353200,353400,200,1
snake-243,snake,353600,353800,200,1
violence-440,violence,356200,356600,400,2
violence-441,violence,356400,358400,2000,10
violence-442,violence,357600,357800,200,1
spider-284,spider,359400,359600,200,1
clown-100,clown,360800,361000,200,1
violence-443,violence,360800,362400,1600,8
clown-101,clown,361800,362200,400,2
spider-285,spider,362800,363600,800,4
violence-444,violence,363600,363800,200,1
spider-286,spider,364200,364400,200,1
violence-445,violence,364200,364600,400,2
snake-244,snake,365000,365400,400,2
blood-23,blood,365600,365800,200,1
snake-245,snake,366000,366800,800,3
spider-287,spider,366200,366400,200,1
blood-24,blood,369200,369400,200,1
snake-246,snake,369400,369600,200,1
snake-247,snake,370400,370800,400,2
violence-446,violence,371600,371800,200,1
item-189,item,372800,373000,200,1
snake-248,snake,373000,373800,800,4
violence-447,violence,373600,373800,200,1
spider-288,spider,375400,375600,200,1
violence-448,violence,376200,376400,200,1
violence-449,violence,377400,378000,600,3
spider-289,spider,377800,378200,400,2
violence-450,violence,378600,378800,200,1
item-190,item,380600,381400,800,2
clown-102,clown,381600,381800,200,1
item-191,item,382000,382200,200,1
blood-25,blood,383800,384000,200,1
item-192,item,384400,384600,200,1
clown-103,clown,384600,384800,200,1
snake-249,snake,385000,385200,200,1
item-193,item,386800,387000,200,1
item-194,item,387400,387600,200,1
snake-250,snake,387800,388000,200,1
violence-451,violence,388000,388200,200,1
snake-251,snake,388600,391200,2600,10
item-195,item,389000,389200,200,1
violence-452,violence,390400,390800,400,2
violence-453,violence,394200,395600,1400,3
blood-26,blood,394600,395400,800,4
clown-104,clown,395400,396800,1400,5
violence-454,violence,397600,397800,200,1
blood-27,blood,397800,398600,800,4
blood-28,blood,399400,400200,800,2
blood-29,blood,400800,401200,400,2
clown-105,clown,400800,401000,200,1
clown-106,clown,402400,403200,800,4
blood-30,blood,403000,403600,600,2
violence-455,violence,403000,403200,200,1
violence-456,violence,405000,405600,600,3
blood-31,blood,405200,406200,1000,3
blood-32,blood,405200,405800,600,2
blood-33,blood,406800,407000,200,1
violence-457,violence,407200,407800,600,3
blood-34,blood,407600,408800,1200,4
clown-107,clown,408000,409200,1200,4
spider-290,spider,409400,409600,200,1
violence-458,violence,409800,411000,1200,5
violence-459,violence,410400,410600,200,1
blood-35,blood,411400,411600,200,1
spider-291,spider,411400,411600,200,1
violence-460,violence,412000,413200,1200,5
blood-36,blood,412400,412600,200,1
spider-292,spider,413200,414400,1200,5
violence-461,violence,414200,414400,200,1
violence-462,violence,416000,423400,7400,28
violence-463,violence,416800,418000,1200,5
snake-252,snake,417200,417400,200,1
spider-293,spider,420000,420400,400,2
spider-294,spider,422800,423000,200,1
violence-464,violence,424000,425600,1600,4
violence-465,violence,426200,427000,800,2
blood-37,blood,426400,426600,200,1
spider-295,spider,426800,427600,800,3
violence-466,violence,427000,432600,5600,22
violence-467,violence,427200,429200,2000,7
violence-468,violence,429600,431000,1400,5
violence-469,violence,431600,431800,200,1
violence-470,violence,433400,433800,400,2
violence-471,violence,433600,433800,200,1
violence-472,violence,433600,433800,200,1
item-196,item,434600,434800,200,1
item-197,item,434800,435000,200,1
violence-473,violence,434800,435000,200,1
violence-474,violence,436600,436800,200,1
violence-475,violence,436800,439000,2200,8
violence-476,violence,436800,437600,800,2
clown-108,clown,437600,437800,200,1
violence-477,violence,438400,438600,200,1
clown-109,clown,439000,439200,200,1
clown-110,clown,439000,439200,200,1
violence-478,violence,439600,442000,2400,9
blood-38,blood,440200,440400,200,1
violence-479,violence,441800,443000,1200,6
spider-296,spider,443600,443800,200,1
spider-297,spider,445200,445400,200,1
violence-480,violence,449800,450000,200,1
snake-253,snake,451400,451600,200,1
snake-254,snake,452600,452800,200,1
violence-481,violence,453600,453800,200,1
item-198,item,454000,454200,200,1
clown-111,clown,454200,454800,600,2
clown-112,clown,456200,456400,200,1
violence-482,violence,457200,457400,200,1
violence-483,violence,458200,458600,400,2
violence-484,violence,461200,461400,200,1
blood-39,blood,462400,462600,200,1
clown-113,clown,463000,463600,600,2
violence-485,violence,464600,464800,200,1
clown-114,clown,466000,466200,200,1
violence-486,violence,468600,468800,200,1
violence-487,violence,469400,469600,200,1
violence-488,violence,470000,470200,200,1
item-199,item,470200,470400,200,1
violence-489,violence,470400,470600,200,1
item-200,item,471400,472000,600,3
violence-490,violence,472000,478400,6400,29
spider-298,spider,472200,472600,400,2
clown-115,clown,472400,473400,1000,4
item-201,item,475000,475200,200,1
blood-40,blood,475400,475600,200,1
clown-116,clown,477400,477600,200,1
item-202,item,477600,478400,800,4
item-203,item,478600,478800,200,1
clown-117,clown,478800,479000,200,1
violence-491,violence,479000,480200,1200,5
item-204,item,480800,481000,200,1
blood-41,blood,481400,481800,400,2
violence-492,violence,483000,483200,200,1
violence-493,violence,484400,485400,1000,3
snake-255,snake,485200,485600,400,2
violence-494,violence,486000,486200,200,1
violence-495,violence,486800,487200,400,2
clown-118,clown,487200,487400,200,1
item-205,item,488200,488400,200,1
violence-496,violence,488400,488600,200,1
clown-119,clown,488600,488800,200,1
violence-497,violence,489000,489200,200,1
item-206,item,489800,490000,200,1
item-207,item,490000,490200,200,1
item-208,item,490600,490800,200,1
violence-498,violence,490800,492000,1200,4
clown-120,clown,491000,491200,200,1
snake-256,snake,491200,491400,200,1
blood-42,blood,491800,492000,200,1
spider-299,spider,495600,495800,200,1
violence-499,violence,501400,501600,200,1
violence-500,violence,501800,502000,200,1
clown-121,clown,502000,502200,200,1
violence-501,violence,503000,503200,200,1
blood-43,blood,504200,504400,200,1
item-209,item,504200,504400,200,1
violence-502,violence,504200,504400,200,1
blood-44,blood,504400,504600,200,1
violence-503,violence,505600,506000,400,2
violence-504,violence,505800,506000,200,1
clown-122,clown,506200,507000,800,4
violence-505,violence,507600,507800,200,1
blood-45,blood,507800,508000,200,1
violence-506,violence,508400,510600,2200,7
violence-507,violence,509000,509200,200,1
clown-123,clown,509400,509800,400,2
violence-508,violence,510400,511000,600,2
clown-124,clown,511400,511600,200,1
violence-509,violence,511800,513000,1200,4
violence-510,violence,512200,512400,200,1
clown-125,clown,512600,512800,200,1
violence-511,violence,513600,513800,200,1
violence-512,violence,514400,514600,200,1
clown-126,clown,515400,515600,200,1
violence-513,violence,515600,515800,200,1
clown-127,clown,517600,518800,1200,6
violence-514,violence,517600,518400,800,4
violence-515,violence,520000,523600,3600,14
spider-300,spider,521400,521600,200,1
blood-46,blood,523200,523400,200,1
clown-128,clown,523400,523600,200,1
violence-516,violence,523400,526400,3000,15
blood-47,blood,524200,524400,200,1
clown-129,clown,524200,524400,200,1
clown-130,clown,525000,527600,2600,12
blood-48,blood,526200,526400,200,1
violence-517,violence,527600,528600,1000,3
clown-131,clown,529200,531000,1800,7
violence-518,violence,529600,529800,200,1
item-210,item,530800,531000,200,1
clown-132,clown,531800,532200,400,2
blood-49,blood,532200,532600,400,2
item-211,item,532200,532800,600,3
blood-50,blood,532400,533400,1000,3
violence-519,violence,532400,533600,1200,5
item-212,item,533400,533800,400,2
blood-51,blood,533600,534000,400,2
clown-133,clown,535800,537000,1200,6
violence-520,violence,543800,544600,800,2
clown-134,clown,546800,548800,2000,8
violence-521,violence,546800,547800,1000,4
clown-135,clown,549400,549800,400,2
violence-522,violence,550200,551200,1000,5
clown-136,clown,550400,551400,1000,4
violence-523,violence,551800,552000,200,1
clown-137,clown,552600,553200,600,3
clown-138,clown,553000,553200,200,1
violence-524,violence,553200,553400,200,1
violence-525,violence,554200,554400,200,1
clown-139,clown,554400,555000,600,3
blood-52,blood,555400,555600,200,1
violence-526,violence,556000,556800,800,3
clown-140,clown,557800,558000,200,1
blood-53,blood,559600,559800,200,1
clown-141,clown,560000,560200,200,1
clown-142,clown,560400,564200,3800,17
violence-527,violence,560400,562600,2200,9
blood-54,blood,562200,562400,200,1
item-213,item,563000,563200,200,1
violence-528,violence,565200,566200,1000,4
clown-143,clown,565600,566800,1200,3
clown-144,clown,567600,578800,11200,52
item-214,item,570000,570200,200,1
violence-529,violence,571600,571800,200,1
item-215,item,573400,573600,200,1
item-216,item,574800,575000,200,1
blood-55,blood,575200,575400,200,1
blood-56,blood,578600,578800,200,1
violence-530,violence,579000,579400,400,2
item-217,item,580400,582000,1600,6
clown-145,clown,580600,580800,200,1
clown-146,clown,581600,581800,200,1
violence-531,violence,582000,582200,200,1
violence-532,violence,583800,585000,1200,3
clown-147,clown,584400,584600,200,1
snake-257,snake,586200,586400,200,1
violence-533,violence,586600,587200,600,2
clown-148,clown,586800,587000,200,1
snake-258,snake,587000,587200,200,1
snake-259,snake,588400,588600,200,1
violence-534,violence,590800,591000,200,1
spider-301,spider,591400,591600,200,1
violence-535,violence,593000,594200,1200,5
clown-149,clown,594400,595000,600,2
violence-536,violence,595400,595600,200,1
clown-150,clown,596000,597400,1400,6
item-218,item,596400,596600,200,1
violence-537,violence,597200,597400,200,1
blood-57,blood,598800,599000,200,1
violence-538,violence,598800,599000,200,1
violence-539,violence,599600,599800,200,1
blood-58,blood,600400,600600,200,1
violence-540,violence,600400,600800,400,2
clown-151,clown,603000,603200,200,1
clown-152,clown,604200,604400,200,1
clown-153,clown,608200,608400,200,1
clown-154,clown,609800,610000,200,1
violence-541,violence,609800,610000,200,1
snake-260,snake,610600,610800,200,1
violence-542,violence,612400,613400,1000,3
blood-59,blood,614200,614400,200,1
item-219,item,615600,615800,200,1
FEMALE_BREAST_EXPOSED-4,FEMALE_BREAST_EXPOSED,617600,617800,200,1
violence-543,violence,623400,623800,400,2
violence-544,violence,624800,625000,200,1
snake-261,snake,627200,627400,200,1
violence-545,violence,627600,627800,200,1
clown-155,clown,629200,629400,200,1
violence-546,violence,629200,630200,1000,4
violence-547,violence,630200,631800,1600,5
violence-548,violence,630800,631200,400,2
clown-156,clown,631600,631800,200,1
clown-157,clown,633000,633200,200,1
clown-158,clown,634200,634400,200,1
blood-60,blood,634400,634600,200,1
violence-549,violence,636000,636800,800,3
spider-302,spider,636200,636400,200,1
spider-303,spider,637000,637200,200,1
violence-550,violence,637200,646800,9600,47
violence-551,violence,637200,640800,3600,13
clown-159,clown,637600,649600,12000,58
violence-552,violence,645000,646400,1400,5
violence-553,violence,647000,647400,400,2
violence-554,violence,647400,647600,200,1
violence-555,violence,648400,648800,400,2
violence-556,violence,649000,650000,1000,4
violence-557,violence,649400,649600,200,1
snake-262,snake,651400,651800,400,2
violence-558,violence,653800,654400,600,3
violence-559,violence,654200,654400,200,1
violence-560,violence,657400,658000,600,3
violence-561,violence,658800,659400,600,3
