id,label,start_ms,end_ms,duration_ms,n_keyframes
violence-174,violence,8000,8700,700,2
violence-175,violence,9500,9700,200,1
violence-176,violence,12000,12200,200,1
violence-177,violence,13000,14200,1200,3
snake-129,snake,15000,15200,200,1
violence-178,violence,15500,15700,200,1
snake-130,snake,16500,16700,200,1
violence-179,violence,18000,18200,200,1
violence-180,violence,19500,19700,200,1
violence-181,violence,19500,19700,200,1
blood-2,blood,20500,20700,200,1
violence-182,violence,21000,25700,4700,10
violence-183,violence,21000,21200,200,1
violence-184,violence,21000,22200,1200,3
violence-185,violence,22000,22200,200,1
violence-186,violence,22000,22200,200,1
violence-187,violence,23000,25700,2700,6
violence-188,violence,24000,24200,200,1
violence-189,violence,26500,26700,200,1
violence-190,violence,27000,28200,1200,3
violence-191,violence,27000,27200,200,1
snake-131,snake,27500,27700,200,1
violence-192,violence,27500,28200,700,2
violence-193,violence,29000,29200,200,1
violence-194,violence,29000,30200,1200,3
violence-195,violence,30000,30200,200,1
violence-196,violence,31000,31700,700,2
violence-197,violence,31500,32200,700,2
violence-198,violence,32500,32700,200,1
violence-199,violence,32500,35700,3200,7
violence-200,violence,32500,32700,200,1
violence-201,violence,33500,33700,200,1
violence-202,violence,34500,34700,200,1
violence-203,violence,35500,35700,200,1
snake-132,snake,36500,36700,200,1
violence-204,violence,37000,37200,200,1
violence-205,violence,40500,44200,3700,8
spider-150,spider,41500,41700,200,1
violence-206,violence,44000,44700,700,2
violence-207,violence,45500,47200,1700,4
item-100,item,46000,46200,200,1
violence-208,violence,47000,53700,6700,14
clown-36,clown,50000,50200,200,1
violence-209,violence,50000,50700,700,2
violence-210,violence,52000,52200,200,1
clown-37,clown,54000,54700,700,2
snake-133,snake,57500,58700,1200,3
violence-211,violence,60000,60200,200,1
clown-38,clown,61000,61200,200,1
blood-3,blood,65000,65200,200,1
blood-4,blood,69500,69700,200,1
violence-212,violence,73000,73200,200,1
violence-213,violence,74000,78200,4200,9
item-101,item,81500,82700,1200,3
item-102,item,83500,87200,3700,8
violence-214,violence,84000,84700,700,2
clown-39,clown,92500,92700,200,1
clown-40,clown,94500,96200,1700,4
violence-215,violence,95500,95700,200,1
snake-134,snake,98000,98700,700,2
violence-216,violence,99500,104700,5200,11
item-103,item,100500,100700,200,1
item-104,item,103500,103700,200,1
item-105,item,105000,105200,200,1
violence-217,violence,105500,106700,1200,3
item-106,item,107000,108200,1200,3
violence-218,violence,108000,109200,1200,3
blood-5,blood,110000,110200,200,1
clown-41,clown,110000,110200,200,1
violence-219,violence,110500,110700,200,1
clown-42,clown,112000,113200,1200,3
violence-220,violence,112500,112700,200,1
blood-6,blood,114000,114200,200,1
clown-43,clown,114000,114200,200,1
violence-221,violence,118500,118700,200,1
violence-222,violence,120500,120700,200,1
violence-223,violence,121500,122200,700,2
blood-7,blood,124000,124200,200,1
violence-224,violence,124000,124200,200,1
violence-225,violence,125000,125200,200,1
clown-44,clown,129000,129200,200,1
blood-8,blood,129500,129700,200,1
spider-151,spider,133500,133700,200,1
violence-226,violence,135500,135700,200,1
violence-227,violence,135500,135700,200,1
violence-228,violence,136500,136700,200,1
snake-135,snake,143000,143700,700,2
violence-229,violence,144000,148200,4200,9
violence-230,violence,146000,147200,1200,3
clown-45,clown,150000,150200,200,1
spider-152,spider,150000,150200,200,1
violence-231,violence,150500,152700,2200,5
violence-232,violence,152000,152200,200,1
violence-233,violence,152500,152700,200,1
violence-234,violence,153000,153200,200,1
violence-235,violence,158000,158200,200,1
clown-46,clown,162000,162200,200,1
clown-47,clown,167500,167700,200,1
violence-236,violence,167500,167700,200,1
violence-237,violence,170000,170700,700,2
violence-238,violence,171500,173200,1700,4
spider-153,spider,176000,176200,200,1
blood-9,blood,176500,176700,200,1
violence-239,violence,180000,180200,200,1
violence-240,violence,182500,184200,1700,4
violence-241,violence,186000,190200,4200,9
clown-48,clown,190500,190700,200,1
violence-242,violence,191000,191200,200,1
violence-243,violence,191000,194700,3700,8
item-107,item,192000,192200,200,1
violence-244,violence,192000,199200,7200,15
violence-245,violence,192000,192200,200,1
clown-49,clown,198000,198200,200,1
violence-246,violence,200000,200700,700,2
spider-154,spider,202000,203200,1200,3
spider-155,spider,206500,206700,200,1
violence-247,violence,207000,216700,9700,20
violence-248,violence,209000,209200,200,1
violence-249,violence,209500,210200,700,2
violence-250,violence,211000,211200,200,1
blood-10,blood,212000,212200,200,1
spider-156,spider,216500,216700,200,1
spider-157,spider,218500,219200,700,2
violence-251,violence,219500,232700,13200,27
blood-11,blood,220000,221200,1200,3
snake-136,snake,220500,220700,200,1
blood-12,blood,222000,222200,200,1
violence-252,violence,224000,224200,200,1
violence-253,violence,225500,225700,200,1
violence-254,violence,226500,226700,200,1
violence-255,violence,227500,228700,1200,3
violence-256,violence,229500,229700,200,1
blood-13,blood,231000,231200,200,1
FEET_EXPOSED-1,FEET_EXPOSED,232000,232200,200,1
snake-137,snake,232500,232700,200,1
violence-257,violence,233000,236200,3200,7
snake-138,snake,233500,233700,200,1
violence-258,violence,237000,237200,200,1
violence-259,violence,238000,238200,200,1
violence-260,violence,238000,238200,200,1
violence-261,violence,240000,240200,200,1
violence-262,violence,241500,241700,200,1
violence-263,violence,242500,247200,4700,10
violence-264,violence,247000,247200,200,1
violence-265,violence,248000,250200,2200,5
blood-14,blood,248500,248700,200,1
violence-266,violence,248500,249200,700,2
violence-267,violence,250000,250200,200,1
violence-268,violence,251000,251200,200,1
violence-269,violence,251000,252200,1200,3
violence-270,violence,253000,258700,5700,12
violence-271,violence,259500,259700,200,1
spider-158,spider,260000,260200,200,1
violence-272,violence,261000,261700,700,2
spider-159,spider,262500,262700,200,1
violence-273,violence,263000,266200,3200,7
violence-274,violence,263000,263200,200,1
violence-275,violence,264000,264200,200,1
violence-276,violence,265000,265200,200,1
violence-277,violence,266000,266200,200,1
violence-278,violence,267500,269200,1700,4
violence-279,violence,270000,271200,1200,3
item-108,item,272000,272200,200,1
violence-280,violence,272000,274700,2700,6
violence-281,violence,272000,272200,200,1
violence-282,violence,273500,273700,200,1
violence-283,violence,273500,274200,700,2
violence-284,violence,275000,275700,700,2
violence-285,violence,275500,276200,700,2
violence-286,violence,276500,281700,5200,11
violence-287,violence,277000,277200,200,1
violence-288,violence,277500,277700,200,1
violence-289,violence,280000,280700,700,2
item-109,item,280500,280700,200,1
spider-160,spider,284000,284200,200,1
violence-290,violence,284500,284700,200,1
violence-291,violence,284500,284700,200,1
violence-292,violence,285500,285700,200,1
violence-293,violence,285500,285700,200,1
clown-50,clown,286000,286200,200,1
violence-294,violence,286500,288200,1700,4
violence-295,violence,286500,286700,200,1
spider-161,spider,287000,287200,200,1
violence-296,violence,287000,287200,200,1
violence-297,violence,288000,288200,200,1
item-110,item,290500,290700,200,1
violence-298,violence,290500,290700,200,1
violence-299,violence,291000,292200,1200,3
blood-15,blood,292500,292700,200,1
violence-300,violence,293000,297700,4700,10
item-111,item,298500,298700,200,1
violence-301,violence,299000,299700,700,2
item-112,item,299500,299700,200,1
violence-302,violence,300500,300700,200,1
violence-303,violence,301000,301200,200,1
violence-304,violence,301500,301700,200,1
violence-305,violence,302000,302700,700,2
violence-306,violence,302500,304200,1700,4
violence-307,violence,303000,303200,200,1
violence-308,violence,303500,305200,1700,4
violence-309,violence,306500,306700,200,1
clown-51,clown,307000,307700,700,2
violence-310,violence,307500,308200,700,2
snake-139,snake,309000,309200,200,1
violence-311,violence,309000,309700,700,2
violence-312,violence,309000,309200,200,1
violence-313,violence,309500,312700,3200,7
item-113,item,310500,310700,200,1
violence-314,violence,312000,312200,200,1
violence-315,violence,313000,313200,200,1
item-114,item,319500,319700,200,1
violence-316,violence,321500,321700,200,1
blood-16,blood,323000,323200,200,1
clown-52,clown,325000,325200,200,1
violence-317,violence,329000,329200,200,1
violence-318,violence,332000,332700,700,2
violence-319,violence,334000,334200,200,1
snake-140,snake,335000,335200,200,1
violence-320,violence,335500,336200,700,2
violence-321,violence,337000,337200,200,1
spider-162,spider,338000,338200,200,1
violence-322,violence,338000,338200,200,1
violence-323,violence,339500,339700,200,1
violence-324,violence,340500,341700,1200,3
violence-325,violence,340500,340700,200,1
violence-326,violence,344000,344200,200,1
violence-327,violence,345500,345700,200,1
violence-328,violence,347000,347200,200,1
clown-53,clown,347500,347700,200,1
violence-329,violence,349000,349700,700,2
violence-330,violence,349500,351200,1700,4
violence-331,violence,350500,350700,200,1
violence-332,violence,351000,351200,200,1
clown-54,clown,352500,352700,200,1
violence-333,violence,352500,352700,200,1
clown-55,clown,354000,354200,200,1
violence-334,violence,356000,358200,2200,5
violence-335,violence,356500,356700,200,1
clown-56,clown,357500,357700,200,1
spider-163,spider,359500,359700,200,1
violence-336,violence,361000,362200,1200,3
clown-57,clown,362000,362200,200,1
blood-17,blood,362500,362700,200,1
spider-164,spider,363000,363200,200,1
violence-337,violence,363500,363700,200,1
violence-338,violence,364500,364700,200,1
snake-141,snake,365000,366200,1200,3
snake-142,snake,372500,373700,1200,3
violence-339,violence,372500,372700,200,1
violence-340,violence,373500,373700,200,1
item-115,item,374500,374700,200,1
violence-341,violence,376000,376200,200,1
violence-342,violence,377000,377700,700,2
spider-165,spider,378000,378200,200,1
snake-143,snake,378500,378700,200,1
item-116,item,382000,382200,200,1
clown-58,clown,384500,384700,200,1
snake-144,snake,385000,385200,200,1
violence-343,violence,388000,388200,200,1
snake-145,snake,388500,390200,1700,4
item-117,item,389000,389200,200,1
violence-344,violence,389500,389700,200,1
violence-345,violence,390500,390700,200,1
snake-146,snake,391000,391200,200,1
violence-346,violence,394500,394700,200,1
blood-18,blood,395000,395200,200,1
clown-59,clown,396000,396700,700,2
blood-19,blood,398000,398700,700,2
clown-60,clown,398500,398700,200,1
blood-20,blood,399500,400200,700,2
blood-21,blood,401000,401200,200,1
clown-61,clown,402500,403200,700,2
blood-22,blood,403000,403200,200,1
violence-347,violence,403000,403200,200,1
violence-348,violence,405000,405700,700,2
blood-23,blood,406000,406200,200,1
violence-349,violence,406500,406700,200,1
blood-24,blood,407500,407700,200,1
violence-350,violence,407500,407700,200,1
clown-62,clown,408000,409200,1200,3
blood-25,blood,408500,408700,200,1
violence-351,violence,410000,410200,200,1
violence-352,violence,410000,410200,200,1
violence-353,violence,411000,413200,2200,5
blood-26,blood,411500,411700,200,1
spider-166,spider,411500,411700,200,1
spider-167,spider,413500,413700,200,1
violence-354,violence,414000,414200,200,1
violence-355,violence,414500,415200,700,2
violence-356,violence,416000,416700,700,2
violence-357,violence,417500,420700,3200,7
violence-358,violence,417500,417700,200,1
spider-168,spider,418500,418700,200,1
spider-169,spider,420000,420200,200,1
violence-359,violence,421500,422200,700,2
spider-170,spider,422500,422700,200,1
violence-360,violence,423000,424200,1200,3
violence-361,violence,427000,429200,2200,5
violence-362,violence,427500,427700,200,1
violence-363,violence,428500,430200,1700,4
violence-364,violence,430000,430200,200,1
violence-365,violence,431000,431200,200,1
violence-366,violence,431000,432700,1700,4
violence-367,violence,431500,431700,200,1
violence-368,violence,433500,433700,200,1
violence-369,violence,436500,436700,200,1
violence-370,violence,437000,437200,200,1
violence-371,violence,437000,437200,200,1
violence-372,violence,438000,438700,700,2
clown-63,clown,438500,438700,200,1
violence-373,violence,438500,438700,200,1
clown-64,clown,439000,439200,200,1
clown-65,clown,439000,439200,200,1
violence-374,violence,441000,442700,1700,4
violence-375,violence,441500,441700,200,1
violence-376,violence,442500,442700,200,1
spider-171,spider,443500,443700,200,1
violence-377,violence,448500,448700,200,1
violence-378,violence,449500,449700,200,1
snake-147,snake,451500,451700,200,1
violence-379,violence,453500,453700,200,1
item-118,item,454000,454200,200,1
clown-66,clown,461500,461700,200,1
clown-67,clown,463000,463200,200,1
violence-380,violence,464500,464700,200,1
spider-172,spider,465500,465700,200,1
clown-68,clown,466000,466200,200,1
violence-381,violence,468000,468200,200,1
clown-69,clown,469500,469700,200,1
violence-382,violence,469500,469700,200,1
violence-383,violence,470000,470200,200,1
item-119,item,471500,471700,200,1
violence-384,violence,472000,472200,200,1
clown-70,clown,473000,473200,200,1
violence-385,violence,473000,474200,1200,3
item-120,item,475000,475700,700,2
violence-386,violence,475000,478200,3200,7
item-121,item,477500,478200,700,2
item-122,item,478500,478700,200,1
violence-387,violence,479000,480200,1200,3
blood-27,blood,481500,481700,200,1
violence-388,violence,483000,483200,200,1
violence-389,violence,485500,486200,700,2
violence-390,violence,486000,486200,200,1
violence-391,violence,486500,486700,200,1
violence-392,violence,487000,487200,200,1
clown-71,clown,488500,488700,200,1
violence-393,violence,489000,489200,200,1
item-123,item,490000,490200,200,1
violence-394,violence,490000,490700,700,2
clown-72,clown,491000,491200,200,1
violence-395,violence,491000,491700,700,2
blood-28,blood,491500,491700,200,1
violence-396,violence,499000,499200,200,1
clown-73,clown,502000,502200,200,1
violence-397,violence,503000,503200,200,1
blood-29,blood,504500,504700,200,1
violence-398,violence,505500,506200,700,2
clown-74,clown,506500,506700,200,1
blood-30,blood,507500,507700,200,1
violence-399,violence,507500,507700,200,1
violence-400,violence,507500,507700,200,1
violence-401,violence,509000,509200,200,1
violence-402,violence,509000,509200,200,1
violence-403,violence,509000,510700,1700,4
clown-75,clown,509500,509700,200,1
violence-404,violence,512000,512200,200,1
clown-76,clown,512500,512700,200,1
violence-405,violence,513500,513700,200,1
violence-406,violence,513500,513700,200,1
violence-407,violence,514500,514700,200,1
violence-408,violence,515500,515700,200,1
clown-77,clown,518000,518700,700,2
violence-409,violence,518000,518200,200,1
violence-410,violence,519500,526200,6700,14
violence-411,violence,524000,524200,200,1
clown-78,clown,524500,525700,1200,3
clown-79,clown,526500,527700,1200,3
clown-80,clown,529500,530200,700,2
clown-81,clown,532000,532200,200,1
blood-31,blood,532500,532700,200,1
item-124,item,532500,532700,200,1
violence-412,violence,532500,532700,200,1
blood-32,blood,533500,533700,200,1
item-125,item,533500,533700,200,1
violence-413,violence,533500,533700,200,1
clown-82,clown,536000,536700,700,2
violence-414,violence,544000,544200,200,1
clown-83,clown,547000,547200,200,1
violence-415,violence,547000,547700,700,2
clown-84,clown,549500,549700,200,1
clown-85,clown,550500,550700,200,1
violence-416,violence,550500,551200,700,2
clown-86,clown,553000,553200,200,1
clown-87,clown,553000,553200,200,1
violence-417,violence,553500,554200,700,2
clown-88,clown,554500,554700,200,1
violence-418,violence,556000,556700,700,2
violence-419,violence,558500,558700,200,1
blood-33,blood,559500,559700,200,1
clown-89,clown,560000,560200,200,1
clown-90,clown,560500,562200,1700,4
violence-420,violence,560500,561700,1200,3
violence-421,violence,562500,562700,200,1
clown-91,clown,563000,564700,1700,4
item-126,item,563000,563200,200,1
violence-422,violence,565500,566700,1200,3
blood-34,blood,567500,567700,200,1
clown-92,clown,567500,578700,11200,23
item-127,item,570000,570200,200,1
violence-423,violence,572000,572200,200,1
violence-424,violence,579000,579200,200,1
item-128,item,580500,581700,1200,3
violence-425,violence,582000,582200,200,1
violence-426,violence,584000,584200,200,1
snake-148,snake,586500,587200,700,2
violence-427,violence,586500,587200,700,2
violence-428,violence,593000,594200,1200,3
violence-429,violence,595500,595700,200,1
clown-93,clown,596000,596700,700,2
blood-35,blood,597500,597700,200,1
clown-94,clown,597500,597700,200,1
violence-430,violence,599500,599700,200,1
violence-431,violence,600500,600700,200,1
clown-95,clown,603000,603200,200,1
violence-432,violence,612500,613700,1200,3
violence-433,violence,622000,622200,200,1
violence-434,violence,623500,623700,200,1
violence-435,violence,624500,624700,200,1
violence-436,violence,626000,626200,200,1
violence-437,violence,627500,627700,200,1
violence-438,violence,629000,631200,2200,5
violence-439,violence,630500,631200,700,2
clown-96,clown,631500,631700,200,1
clown-97,clown,633000,633200,200,1
violence-440,violence,636000,636200,200,1
spider-173,spider,637000,637200,200,1
clown-98,clown,637500,638200,700,2
violence-441,violence,637500,646700,9200,19
violence-442,violence,638000,638200,200,1
clown-99,clown,639000,649200,10200,21
violence-443,violence,639000,640700,1700,4
violence-444,violence,644500,646200,1700,4
violence-445,violence,647000,649700,2700,6
violence-446,violence,647500,647700,200,1
violence-447,violence,648500,648700,200,1
snake-149,snake,651500,651700,200,1
violence-448,violence,653000,653200,200,1
violence-449,violence,654000,654200,200,1
violence-450,violence,657500,658200,700,2
violence-451,violence,659000,659700,700,2
