id,label,start_ms,end_ms,duration_ms,n_keyframes
blood-19,blood,6200,16000,9800,47
item-107,item,7600,7800,200,1
violence-145,violence,9600,9800,200,1
item-108,item,9800,10000,200,1
violence-146,violence,11200,15600,4400,22
item-109,item,11600,11800,200,1
violence-147,violence,20000,20400,400,2
item-110,item,22600,22800,200,1
item-111,item,23600,23800,200,1
item-112,item,29600,29800,200,1
spider-143,spider,30800,32600,1800,9
blood-20,blood,33200,33400,200,1
blood-21,blood,36200,36400,200,1
spider-144,spider,36400,36600,200,1
BELLY_EXPOSED-9,BELLY_EXPOSED,37800,39200,1400,4
FEMALE_GENITALIA_COVERED-17,FEMALE_GENITALIA_COVERED,37800,38400,600,3
clown-49,clown,38400,39000,600,3
BUTTOCKS_COVERED-11,BUTTOCKS_COVERED,44400,44800,400,2
BUTTOCKS_COVERED-12,BUTTOCKS_COVERED,53200,53400,200,1
BUTTOCKS_COVERED-13,BUTTOCKS_COVERED,54000,55400,1400,7
blood-22,blood,57800,58000,200,1
item-113,item,63800,64000,200,1
item-114,item,64600,65000,400,2
item-115,item,66800,68600,1800,9
item-116,item,69400,69600,200,1
item-117,item,70200,70600,400,2
blood-23,blood,70600,71200,600,3
blood-24,blood,71800,72200,400,2
blood-25,blood,73800,74800,1000,3
violence-148,violence,75400,79000,3600,17
item-118,item,75600,75800,200,1
violence-149,violence,75600,75800,200,1
item-119,item,76600,78600,2000,9
ARMPITS_EXPOSED-1,ARMPITS_EXPOSED,77000,79000,2000,9
FEMALE_BREAST_COVERED-14,FEMALE_BREAST_COVERED,77400,78600,1200,6
blood-26,blood,79000,79200,200,1
blood-27,blood,80000,81000,1000,3
ARMPITS_EXPOSED-2,ARMPITS_EXPOSED,82000,83800,1800,9
ARMPITS_EXPOSED-3,ARMPITS_EXPOSED,83600,83800,200,1
blood-28,blood,83600,83800,200,1
item-120,item,83800,84200,400,2
BELLY_EXPOSED-10,BELLY_EXPOSED,85400,86800,1400,7
FEMALE_GENITALIA_COVERED-18,FEMALE_GENITALIA_COVERED,86000,86200,200,1
blood-29,blood,88800,89000,200,1
clown-50,clown,91800,94400,2600,12
clown-51,clown,100000,100200,200,1
FEMALE_BREAST_COVERED-15,FEMALE_BREAST_COVERED,110000,110600,600,3
clown-52,clown,110000,110800,800,4
ARMPITS_EXPOSED-4,ARMPITS_EXPOSED,110800,113800,3000,13
item-121,item,110800,115600,4800,24
ARMPITS_EXPOSED-5,ARMPITS_EXPOSED,112200,112400,200,1
blood-30,blood,112200,113000,800,2
ARMPITS_EXPOSED-6,ARMPITS_EXPOSED,115000,115600,600,3
FEMALE_BREAST_COVERED-16,FEMALE_BREAST_COVERED,115600,118800,3200,16
ARMPITS_EXPOSED-7,ARMPITS_EXPOSED,117800,118800,1000,4
blood-31,blood,118800,119000,200,1
clown-53,clown,120200,121400,1200,5
blood-32,blood,122000,122400,400,2
blood-33,blood,122000,122200,200,1
blood-34,blood,123600,123800,200,1
ARMPITS_EXPOSED-8,ARMPITS_EXPOSED,124400,127000,2600,13
blood-35,blood,125200,125600,400,2
clown-54,clown,137600,137800,200,1
clown-55,clown,138400,138800,400,2
item-122,item,140200,142000,1800,5
item-123,item,143600,147000,3400,17
blood-36,blood,144000,147000,3000,15
violence-150,violence,146600,147000,400,2
item-124,item,147000,149000,2000,9
item-125,item,149800,150600,800,4
blood-37,blood,154000,154200,200,1
clown-56,clown,155600,155800,200,1
blood-38,blood,164600,164800,200,1
item-126,item,164600,164800,200,1
item-127,item,165600,167200,1600,8
item-128,item,169600,174200,4600,22
blood-39,blood,170000,172800,2800,14
clown-57,clown,173200,173400,200,1
item-129,item,175400,177200,1800,7
item-130,item,176200,179400,3200,12
violence-151,violence,177000,177600,600,2
clown-58,clown,181600,181800,200,1
item-131,item,184200,184400,200,1
clown-59,clown,186800,187600,800,4
clown-60,clown,189400,191000,1600,7
violence-152,violence,190400,190600,200,1
clown-61,clown,191800,192000,200,1
clown-62,clown,199000,199800,800,4
clown-63,clown,201200,201600,400,2
clown-64,clown,211000,211800,800,3
clown-65,clown,212600,213200,600,2
violence-153,violence,212600,213200,600,3
blood-40,blood,216600,216800,200,1
item-132,item,216600,219600,3000,15
clown-66,clown,223400,226600,3200,12
violence-154,violence,223400,224800,1400,5
clown-67,clown,233200,233600,400,2
clown-68,clown,234600,236400,1800,7
clown-69,clown,241000,242200,1200,4
clown-70,clown,244200,244600,400,2
blood-41,blood,250600,253400,2800,12
item-133,item,250600,253400,2800,14
item-134,item,250600,253400,2800,14
clown-71,clown,256200,259200,3000,15
violence-155,violence,258000,258200,200,1
clown-72,clown,262200,262600,400,2
clown-73,clown,267800,269400,1600,7
clown-74,clown,271200,271400,200,1
clown-75,clown,275800,276000,200,1
blood-42,blood,283800,284000,200,1
clown-76,clown,284000,285600,1600,7
clown-77,clown,288200,288400,200,1
clown-78,clown,289200,289400,200,1
clown-79,clown,295000,295800,800,2
clown-80,clown,302400,302800,400,2
clown-81,clown,304000,304200,200,1
blood-43,blood,307800,316800,9000,43
item-135,item,307800,316600,8800,44
violence-156,violence,307800,308000,200,1
violence-157,violence,309200,309400,200,1
blood-44,blood,318200,322800,4600,23
item-136,item,320200,322800,2600,13
clown-82,clown,339600,339800,200,1
violence-158,violence,360000,360200,200,1
clown-83,clown,364800,365000,200,1
clown-84,clown,368800,369000,200,1
clown-85,clown,371400,371800,400,2
clown-86,clown,375400,375800,400,2
blood-45,blood,376000,376400,400,2
clown-87,clown,376800,377200,400,2
clown-88,clown,379600,379800,200,1
clown-89,clown,383600,383800,200,1
clown-90,clown,385800,386000,200,1
clown-91,clown,401200,401400,200,1
clown-92,clown,403800,404200,400,2
clown-93,clown,413200,413400,200,1
clown-94,clown,414000,416800,2800,12
clown-95,clown,417400,417600,200,1
clown-96,clown,418200,418400,200,1
item-137,item,419200,419400,200,1
clown-97,clown,420800,421000,200,1
clown-98,clown,433800,435200,1400,7
clown-99,clown,436200,437200,1000,3
item-138,item,437400,437800,400,2
clown-100,clown,440200,441200,1000,4
clown-101,clown,442400,442600,200,1
clown-102,clown,450000,451400,1400,5
clown-103,clown,457200,458400,1200,3
item-139,item,460200,466200,6000,30
clown-104,clown,466200,470000,3800,17
clown-105,clown,472200,472400,200,1
clown-106,clown,473000,474600,1600,7
item-140,item,475200,477800,2600,13
blood-46,blood,477800,486400,8600,43
blood-47,blood,477800,486400,8600,43
item-141,item,477800,484800,7000,35
item-142,item,485600,486400,800,4
blood-48,blood,510400,513400,3000,15
